11111111111
100000E0001
1C1000C00C1
11111111111