11111111111
10000E00001
1C1000C0P01
11111111111