11111111111
10000E00001
1C1000C0PC0
11111111111